########
I #    #
# # ## #
# #  #$#
#    ###
#### # #
#$   #$#
########
